international_flight	domestic_flight	
ill_nature	good_nature	
insecurity	security	
changelessness	changeableness	
uselessness	usefulness	
wrong	right	
mendacity	veracity	
friend	foe	
reversible_process	irreversible_process	
reverence	irreverence	
incorruptibility	corruptibility	
unskillfulness	skillfulness	
verboseness	terseness	
optimist	pessimist	
propitiousness	unpropitiousness	
tangibility	intangibility	
noblewoman	nobleman	
benignity	malignity	
bottom	top	
impracticability	practicability	
overgarment	undergarment	
put_option	call_option	
hopefulness	hopelessness	
draftee	volunteer	
visibility	invisibility	
influx	efflux	
lowercase	uppercase	
inconsequence	consequence	
instability	stability	
judiciousness	injudiciousness	
nonbeing	being	
motionlessness	motion	
mediacy	immediacy	
mercilessness	mercifulness	
being	nonbeing	
superiority	inferiority	
endogamy	exogamy	
marginality	centrality	
Lady	Lord	
staleness	freshness	
intelligibility	unintelligibility	
greenness	ripeness	
stoutheartedness	faintheartedness	
expectedness	unexpectedness	
cheerfulness	cheerlessness	uncheerfulness	
singular	plural	
skim_milk	whole_milk	
incapableness	capableness	
disembarkation	embarkation	
unimportance	importance	
unseemliness	seemliness	
untrustworthiness	trustworthiness	
synchronizing	desynchronizing	
agitation	calmness	
atonality	tonality	
noninterference	interference	
monosemy	polysemy	
waning	waxing	
confidence	diffidence	
comedy	tragedy	
uncleanliness	cleanliness	
inattentiveness	attentiveness	
female_sibling	male_sibling	
coherence	incoherence	
altruism	egoism	
appetizingness	unappetizingness	
irrelevance	relevance	
stator	rotor	
sharpness	softness	dullness	
unsteadiness	steadiness	
artificial_language	natural_language	
worth	worthlessness	
disreputability	reputability	
unexpectedness	expectedness	
stinginess	generosity	
poor_people	rich_people	
voltaic_cell	electrolytic_cell	
stillbirth	live_birth	
guilt	innocence	
immediacy	mediacy	
aunt	uncle	
unconscientiousness	conscientiousness	
downtime	uptime	
cooperation	competition	
colorlessness	color	
acceleration	deceleration	
night	day	
catalyst	anticatalyst	
insalubriousness	salubriousness	
centrality	marginality	
susceptibility	unsusceptibility	
allogamy	autogamy	
male_monarch	female_monarch	
leaded_gasoline	unleaded_gasoline	
market_economy	non-market_economy	
hypercapnia	hypocapnia	
death	birth	
falsehood	truth	
cathode	anode	
capability	incapability	
carefulness	carelessness	
piety	impiety	
intervention	nonintervention	
unlawfulness	lawfulness	
inactivation	activation	
poor	rich	
unselfconsciousness	self-consciousness	
foul_ball	fair_ball	
bull	bear	
unpointedness	pointedness	
volunteer	draftee	
hypotension	hypertension	
artfulness	artlessness	
dedicated_file_server	non-dedicated_file_server	
aphrodisia	anaphrodisia	
counterfactuality	factuality	
absence	presence	
territorial_waters	high_sea	international_waters	
solvency	insolvency	
unsusceptibility	susceptibility	
impracticableness	practicableness	
softness	loudness	sharpness	hardness	
silence	sound	
inauspiciousness	auspiciousness	
substantiality	insubstantiality	
materiality	immateriality	
unnaturalness	naturalness	
esteem	disesteem	
insignificance	significance	
low_spirits	high	
finiteness	infiniteness	
debtor	creditor	
varietal_wine	generic_wine	
gain	loss	
assortative_mating	disassortative_mating	
object_program	source_program	
valgus	varus	
stableness	unstableness	
loyalty	disloyalty	
disassembly	assembly	
hairlessness	hairiness	
symmetry	asymmetry	
armament	disarmament	
uncertainty	certainty	
inexpensiveness	expensiveness	
uncongeniality	congeniality	
failing	passing	
approbation	disapprobation	
perceptiveness	unperceptiveness	
spiny-finned_fish	soft-finned_fish	
cowardice	courage	
dead	living	
hereditarianism	environmentalism	
strengthening	weakening	
father	mother	
boy	girl	
frivolity	seriousness	
unconnectedness	connectedness	
disassortative_mating	assortative_mating	
hotness	coldness	
invariableness	variableness	
tribalization	detribalization	
decriminalization	criminalization	
custom-made	ready-made	
live_birth	stillbirth	
plausibility	implausibility	
dextrorotation	levorotation	
autogamy	allogamy	
estrus	anestrus	
composure	discomposure	
minimum	maximum	
rainy_season	dry_season	
comfort	discomfort	
prudence	imprudence	
sophistication	naivete	
dysgenics	eugenics	
tameness	wildness	
thereness	hereness	
unemotionality	emotionality	
international_law	civil_law	
consanguinity	affinity	
anode	cathode	
special_verdict	general_verdict	
easy_money	tight_money	
unsuitability	suitability	
normality	abnormality	
apoapsis	periapsis	
hyperkalemia	hypokalemia	
incompetence	competence	
pleasantness	unpleasantness	
impermissibility	permissibility	
soft_water	hard_water	
general_verdict	special_verdict	
good_humor	ill_humor	
conspicuousness	inconspicuousness	
payment	nonpayment	
perfection	imperfection	
mercifulness	mercilessness	
disarmament	armament	
starboard	larboard	
success	failure	
inaccessibility	accessibility	
nonconformity	conformity	
low_quality	high_quality	
augmentation	diminution	
intron	exon	
fatness	leanness	
denationalization	nationalization	
indistinctness	distinctness	
hardball	softball	
borrower	lender	
friendly	hostile	
experience	inexperience	
unemployment	employment	
perceptibility	imperceptibility	
springtide	neap_tide	
reputability	disreputability	
cacodemon	eudemon	
femininity	masculinity	
figure	ground	
naivete	sophistication	
unholiness	holiness	
usefulness	uselessness	
unleaded_gasoline	leaded_gasoline	
paper_profit	paper_loss	
embarkation	disembarkation	
cash	credit	
yea	nay	
direct_evidence	circumstantial_evidence	
complex_instruction_set_computer	reduced_instruction_set_computer	
immersion	emersion	
wet-bulb_thermometer	dry-bulb_thermometer	
unambiguity	ambiguity	
king	queen	
inconvenience	convenience	
attention	inattention	
precision	imprecision	
restraint	unrestraint	
hospitality	inhospitality	
permanence	impermanence	
passive_trust	active_trust	
perviousness	imperviousness	
pretentiousness	unpretentiousness	
roughness	smoothness	
superior	inferior	
priority	posteriority	
boarding_school	day_school	
off-season	high_season	
joy	sorrow	
generic_wine	varietal_wine	
repute	disrepute	
neap_tide	springtide	
impartiality	partiality	
ugliness	beauty	
wisdom	folly	
recto	verso	
heterocercal_fin	homocercal_fin	
affirmation	reversal	
morality	immorality	
classicist	romanticist	
classicism	Romanticism	
reversal	affirmation	
best	worst	
child	parent	
in-basket	out-basket	
coldness	hotness	
anabolism	catabolism	
despair	hope	
lay_witness	expert_witness	
front_burner	back_burner	
juvenile	adult	
liberal	conservative	
nondriver	driver	
cleanliness	uncleanliness	
worldliness	otherworldliness	
unbreakableness	breakableness	
acrocarp	pleurocarp	
insomnia	hypersomnia	
unprofitability	profitability	
future	past	
spoils_system	merit_system	
prescription_drug	over-the-counter_drug	
mortal_sin	venial_sin	
antapex	apex	
fairness	unfairness	
nonattendance	attendance	
gutsiness	gutlessness	
compliance	noncompliance	
bigness	littleness	
depigmentation	pigmentation	
incoordination	coordination	
yang	yin	
electrolytic_cell	voltaic_cell	
irreversible_process	reversible_process	
sensitiveness	insensitiveness	
untidiness	tidiness	
location	studio	
formalism	imitation	
hospitableness	inhospitableness	
supination	pronation	
competence	incompetence	
incorruptness	corruptness	
hope	despair	
disapprobation	approbation	
declassification	classification	
injustice	justice	
laity	clergy	
rest_day	workday	
unseasonableness	seasonableness	
clergyman	layman	
cash_account	margin_account	
doctrine_of_analogy	cataphatism	apophatism	
liveborn_infant	stillborn_infant	
likeliness	unlikeliness	
inhospitality	hospitality	
slave_state	free_state	
ascent	descent	
snail_mail	e-mail	email	electronic_mail	
truthfulness	untruthfulness	
unexchangeability	exchangeability	
untimeliness	timeliness	
high_status	low_status	
disadvantage	advantage	
appropriateness	inappropriateness	
generosity	stinginess	
effortfulness	effortlessness	
power	powerlessness	
purposefulness	purposelessness	
infelicity	felicity	
palingenesis	cenogenesis	
fixed-width_font	proportional_font	
misconception	conception	
purity	impurity	
achromatic_color	chromatic_color	
immortality	mortality	
solubility	insolubility	
incorporeality	corporeality	
disassociation	association	
irreversibility	reversibility	
sunset	sunrise	
relatedness	unrelatedness	
serial_operation	parallel_operation	
finish	start	
rear	front	head	
uppercase	lowercase	
conservative	liberal	
hyperglycemia	hypoglycemia	
credibility	incredibility	
unsociability	sociability	
unpleasantness	pleasantness	
cleanness	dirtiness	
weakening	strengthening	
approachability	unapproachability	
healthfulness	unhealthfulness	
foot	head	
unpropitiousness	propitiousness	
unrespectability	respectability	
gutlessness	gutsiness	
angularity	roundness	
probability	improbability	
exchangeability	unexchangeability	
cheerlessness	cheerfulness	
decontamination	contamination	
nonparticipation	participation	
flexor	extensor	
lowness	highness	
tastelessness	tastefulness	
overachievement	underachievement	
northernness	southernness	
inhibitor	activator	
exclusion	inclusion	
immovability	movability	
diapsid	anapsid	
infallibility	fallibility	
home_game	away_game	
evolution	devolution	
approval	disapproval	
addition	subtraction	
efflux	influx	
good_part	weak_part	
expansion	contraction	
impurity	purity	
reversibility	irreversibility	
activation	inactivation	deactivation	
vulnerability	invulnerability	
whole_milk	skim_milk	
stupidity	intelligence	
soberness	drunkenness	
brightness	dullness	
inflow	outflow	
inconsistency	consistency	
immutability	mutability	
fertility	infertility	
artlessness	artfulness	
pain	pleasure	
distrust	trust	
email	snail_mail	
partiality	impartiality	
stability	instability	
disinflation	inflation	deflation	
diving_duck	dabbling_duck	
brand-name_drug	generic_drug	
negative_charge	positive_charge	
unorthodoxy	orthodoxy	
middle	end	beginning	
commonality	individuality	
opacity	clarity	transparency	
unpopularity	popularity	
liar	square_shooter	
eremite	cenobite	
sadist	masochist	
general_agent	special_agent	
clergy	laity	
smart_bomb	dumb_bomb	
existence	nonexistence	
satisfactoriness	unsatisfactoriness	
conscientiousness	unconscientiousness	
supply	demand	
openness	closeness	
destabilization	stabilization	
dishonesty	honesty	
alignment	nonalignment	
integration	segregation	
dystopia	utopia	
anaphrodisia	aphrodisia	
earliness	lateness	
chromatic_color	achromatic_color	
insufficiency	sufficiency	
invulnerability	vulnerability	
asynchronous_operation	synchronous_operation	
unrighteousness	righteousness	
equilibrium	disequilibrium	
fallibility	infallibility	
passing	failing	
winter_solstice	summer_solstice	
plantigrade_mammal	digitigrade_mammal	
citizen	noncitizen	
improperness	properness	
impermanence	permanence	
nonresident	resident	
orthodoxy	unorthodoxy	
incognizance	cognizance	
end	middle	beginning	
unscrupulousness	scrupulousness	
inessential	essential	
victory	defeat	
nonexistence	existence	
euphoria	dysphoria	
nonpartisan	partisan	
elegance	inelegance	
effectiveness	ineffectiveness	
capacity	incapacity	
contamination	decontamination	
sleepiness	wakefulness	
subordination	insubordination	
hairiness	hairlessness	
head	foot	tail	rear	
leanness	fatness	
unequivocalness	equivocalness	
obtuseness	acuteness	
depreciation	appreciation	
variability	invariability	
hard_drug	soft_drug	
admissibility	inadmissibility	
explicitness	inexplicitness	
longness	shortness	
inexactness	exactness	
color	colorlessness	
indestructibility	destructibility	
corpuscular_theory_of_light	wave_theory_of_light	
congeniality	uncongeniality	
criminalisation	decriminalisation	
eligibility	ineligibility	
imitation	formalism	
insensibility	sensibility	
boldness	timidity	
heaviness	lightness	
antonym	synonym	
activity	inactivity	
dysphemism	euphemism	
disunion	union	
repulsion	attraction	
fruitlessness	fruitfulness	
CISC	RISC	
export	import	
one-dimensional_language	multidimensional_language	
lowland	highland	
immutableness	mutableness	
tastefulness	tastelessness	
carinate	ratite	
nonsingular_matrix	singular_matrix	
improvidence	providence	
sincerity	insincerity	
reentrant_angle	salient_angle	
ambiversion	extraversion	introversion	
animateness	inanimateness	
member	nonmember	
loser	achiever	winner	
extension	flexion	
Athanasianism	Arianism	
scrupulousness	unscrupulousness	
female_aristocrat	male_aristocrat	
persuasiveness	unpersuasiveness	
unearned_run	earned_run	
clarity	opacity	obscurity	
foreignness	nativeness	
worker	nonworker	
right_triangle	oblique_triangle	
inpatient	outpatient	
solvability	unsolvability	
classification	declassification	
nonmember	member	
inside	outside	
benignancy	malignancy	
wetness	dryness	
cultivated_plant	weed	
dumb_bomb	smart_bomb	
disrepute	repute	
incredibility	credibility	
incompressibility	compressibility	
descending_node	ascending_node	
impalpability	palpability	
desynchronization	synchronization	
folly	wisdom	
merit	demerit	
active_voice	passive_voice	
uninitiate	initiate	
conception	misconception	
natural_object	artifact	
radial_symmetry	radial_asymmetry	
pluralism	monism	
polyphony	monophony	
varus	valgus	
oblique_triangle	right_triangle	
sitter	stander	
effortlessness	effortfulness	
belief	unbelief	
misogyny	philogyny	
niceness	nastiness	
centripetal_force	centrifugal_force	
dovishness	hawkishness	
diminution	augmentation	
verso	recto	
hardness	softness	
stabilisation	destabilisation	
breakableness	unbreakableness	
illogicalness	logicalness	
prosecution	defense	
inaccuracy	accuracy	
uncreativeness	creativeness	
unpretentiousness	pretentiousness	
illegibility	legibility	
split_ticket	straight_ticket	
hawk	dove	
affectedness	unaffectedness	
truth	falsehood	falsity	
gratitude	ingratitude	
inhumaneness	humaneness	
indecisiveness	decisiveness	
audibility	inaudibility	
sanity	insanity	
capableness	incapableness	
steadiness	unsteadiness	
corruptibility	incorruptibility	
obscurity	clarity	prominence	
software	hardware	
unfavorableness	favorableness	
productiveness	unproductiveness	
daughter	son	
absorbency	nonabsorbency	
special_agent	general_agent	
infield	outfield	
negative	affirmative	
transparency	opacity	
surface_ship	submersible	
centrifugal_force	centripetal_force	
corpuscular_theory	wave_theory	
imprecision	precision	
apolune	perilune	
unproductiveness	productiveness	
properness	improperness	
disloyalty	loyalty	
love	hate	
dependableness	undependableness	
engagement	non-engagement	
dispensability	indispensability	
uncle	aunt	
unconcern	concern	
fat_person	thin_person	
unloading	loading	
retreat	advance	
lumper	splitter	
porosity	solidity	
anisotropy	isotropy	
scarcity	abundance	
beneficence	maleficence	
increase	decrease	
civil_law	international_law	
cold_war	hot_war	
universal_proposition	particular_proposition	
aliquot	aliquant	
homozygosity	heterozygosity	
zenith	nadir	
unalterability	alterability	
sadness	happiness	
reliability	unreliability	
thickness	thinness	
negativeness	positiveness	
trustworthiness	untrustworthiness	
unhealthfulness	healthfulness	
tonality	atonality	
cooking_apple	eating_apple	
popularity	unpopularity	
skillfulness	unskillfulness	
decisiveness	indecisiveness	
preciseness	impreciseness	
anastalsis	peristalsis	
heir_apparent	heir_presumptive	
monophonic_music	polyphonic_music	
decency	indecency	
impreciseness	preciseness	
unvariedness	variedness	
unrestraint	restraint	
acidity	alkalinity	
unusualness	usualness	
submersible	surface_ship	
literacy	illiteracy	
alternating_current	direct_current	
heedfulness	heedlessness	
even-toed_ungulate	odd-toed_ungulate	
hypocapnia	hypercapnia	
antitype	type	
holism	atomism	
multiculturalism	nationalism	
demerit	merit	
inutility	utility	
worthlessness	worth	
worthiness	unworthiness	
credit	cash	debit	
unappetizingness	appetizingness	
adult	juvenile	
pride	humility	
informality	formality	
minority	majority	
indispensability	dispensability	
dissimilarity	similarity	
unclearness	clearness	
devolution	evolution	
rightfulness	wrongfulness	
pleurocarp	acrocarp	
agonist	antagonist	
contraindication	indication	
inadmissibility	admissibility	
tribalisation	detribalisation	
consciousness	unconsciousness	
malleability	unmalleability	
malignity	benignity	
hyperopia	myopia	
widening	narrowing	
psychotic_depression	neurotic_depression	
non-involvement	involvement	
advance	retreat	
self-pollination	cross-pollination	
tidiness	untidiness	
illegitimacy	legitimacy	
suitableness	unsuitableness	
judgment_in_personam	judgment_in_rem	
equivocalness	unequivocalness	
general	specific	particular	
workday	rest_day	
splitter	lumper	
biodegradable_pollution	nonbiodegradable_pollution	
majority	minority	
acceptability	unacceptability	
irreverence	reverence	
day	night	
discipline	indiscipline	
unsatisfactoriness	satisfactoriness	
smallness	largeness	
stranger	acquaintance	
incurability	curability	
acquaintance	stranger	
hypernatremia	hyponatremia	
syncategoreme	categoreme	
conceit	humility	
decrease	increase	
dissonance	harmony	
Phanerogamae	Cryptogamia	
synchronism	asynchronism	
obtrusiveness	unobtrusiveness	
freshness	staleness	
awkwardness	gracefulness	
high_sea	territorial_waters	
inwardness	outwardness	
petit_larceny	grand_larceny	
certainty	uncertainty	
deflationary_spiral	inflationary_spiral	
dissimilitude	similitude	
nonuniformity	uniformity	
complexity	simplicity	
fitness	unfitness	
wariness	unwariness	
legibility	illegibility	
dullness	sharpness	brightness	
sociability	unsociability	
insensitiveness	sensitiveness	
acquittal	conviction	
node	antinode	
infiniteness	finiteness	
movability	immovability	
terseness	verboseness	
propriety	impropriety	
illicitness	licitness	
elation	depression	
littleness	bigness	
unbelief	belief	
narrowing	widening	
high_quality	low_quality	
unfairness	fairness	
softball	hardball	
consequence	inconsequence	
disappearance	appearance	
abnormality	normality	
ordinariness	extraordinariness	
soft-finned_fish	spiny-finned_fish	
becomingness	unbecomingness	
unwariness	wariness	
mental_health	mental_illness	
nearness	farness	
nonabsorbency	absorbency	
unpalatability	palatability	
genuineness	spuriousness	
unintelligibility	intelligibility	
passive_voice	active_voice	
masochist	sadist	
urban_area	rural_area	
activeness	inactiveness	
specialist	generalist	
here	there	
detribalization	tribalization	
unstratified_language	stratified_language	
centralization	decentralization	
beauty	ugliness	
fidelity	infidelity	
circumstantial_evidence	direct_evidence	
safeness	dangerousness	
wealth	poverty	
anteriority	posteriority	
hyperpnea	hypopnea	
naturalness	unnaturalness	
pro	con	
modesty	immodesty	
connectedness	unconnectedness	disconnectedness	
ease	difficulty	
mobility	immobility	
disagreement	agreement	
inactiveness	activeness	
myopia	hyperopia	
listed_security	unlisted_security	
typicality	atypicality	
good_luck	bad_luck	
presentness	futurity	pastness	
powerlessness	powerfulness	power	
stop_consonant	continuant_consonant	
mindfulness	unmindfulness	
superficiality	profundity	
nonsmoker	smoker	
convertibility	inconvertibility	
fruitfulness	fruitlessness	
hollowness	solidity	
atonicity	tonicity	
debit	credit	
captor	liberator	
decrement	increment	
complex_instruction_set_computing	reduced_instruction_set_computing	
uninsurability	insurability	
bad_weather	good_weather	
looseness	fixedness	tightness	
prokaryote	eukaryote	
shallowness	deepness	
international_waters	territorial_waters	
immotility	motility	
decompression	compression	
dispensableness	indispensableness	
holiness	unholiness	
day_school	night_school	boarding_school	
straight_ticket	split_ticket	
proliferation	non-proliferation	nonproliferation	
prescriptive_linguistics	descriptive_linguistics	
defeat	victory	
demobilization	mobilization	
tributary	distributary	
acuteness	obtuseness	
godliness	ungodliness	
low_tide	high_tide	
parasite	host	
good_egg	bad_egg	
expensiveness	inexpensiveness	
farness	nearness	
demonetization	monetization	
woman	man	
order	disorder	
pessimism	optimism	
pessimist	optimist	
high	low_spirits	low	
nephew	niece	
mobilization	demobilization	
away_game	home_game	
rightness	wrongness	
descent	ascent	
incorrectness	correctness	
saltwater	fresh_water	
reality	unreality	
positive_charge	negative_charge	
similitude	dissimilitude	
professional	amateur	
irresponsibility	responsibility	
environmentalism	hereditarianism	
aphelion	perihelion	
lender	borrower	
dilution	concentration	
unreliability	reliability	
equivalence	nonequivalence	
perihelion	aphelion	
uptime	downtime	
natural_language	artificial_language	
affirmative	negative	
familiarity	unfamiliarity	
incompatibility	compatibility	
clearness	unclearness	
waxing	waning	
indecorousness	decorousness	
uncommunicativeness	communicativeness	
infeasibility	feasibility	
dissatisfaction	satisfaction	
nonbiodegradable_pollution	biodegradable_pollution	
nay	yea	
polysemy	monosemy	
permissiveness	unpermissiveness	
penalty	reward	
heir_presumptive	heir_apparent	
female_parent	male_parent	
persuasion	dissuasion	
winner	loser	
employer	employee	
employee	employer	
perigee	apogee	
wellness	illness	unwellness	
illiteracy	literacy	
imbalance	balance	
pleasure_principle	reality_principle	
disorderliness	orderliness	
hypotonus	hypertonus	
outgo	income	
receptor	effector	
utility	inutility	
curability	incurability	
practicability	impracticability	
incaution	caution	
unattractiveness	attractiveness	
convenience	inconvenience	
roundness	angularity	
particularity	generality	
apogee	perigee	
hypervolemia	hypovolemia	
crookedness	straightness	
venial_sin	mortal_sin	
bad	good	
smoker	nonsmoker	
congruousness	incongruousness	
perfectibility	imperfectibility	
maximization	minimization	
cross-fertilization	self-fertilization	
unpredictability	predictability	
girl	boy	
living	dead	
high_tide	low_tide	
permissibility	impermissibility	
curableness	incurableness	
improbability	probability	
decorousness	indecorousness	
over-the-counter_medicine	prescription_medicine	
income	outgo	
power_mower	hand_mower	
continuant_consonant	stop_consonant	
resolution	preparation	
inconsideration	consideration	
oblique	nominative	
abstractness	concreteness	
heterodactyl_foot	zygodactyl_foot	
difficulty	ease	
female_offspring	male_offspring	
Anglophobia	Anglophilia	
unapproachability	approachability	
carelessness	carefulness	
aptness	inaptness	
nondevelopment	development	
hypertonicity	hypotonicity	
endotoxin	exotoxin	
enlightenment	unenlightenment	
paper_loss	paper_profit	
bad_person	good_person	
expert_witness	lay_witness	
slow_lane	fast_lane	
kindness	unkindness	
posteriority	priority	anteriority	
tractability	intractability	
responsibleness	irresponsibleness	
inaptness	aptness	
comprehensibility	incomprehensibility	
bear	bull	
disservice	service	
Anglican	Nonconformist	
appearance	disappearance	
generic_drug	brand-name_drug	
essentiality	inessentiality	
toadstool	mushroom	
introvert	extrovert	
congruity	incongruity	
unadaptability	adaptability	
rise	fall	
humility	conceit	pride	
distinctness	indistinctness	
trustiness	untrustiness	
constancy	inconstancy	
minor_surgery	major_surgery	
availability	unavailability	
heterozygosity	homozygosity	
unbecomingness	becomingness	
incomprehension	comprehension	
comprehension	incomprehension	
punctuality	tardiness	
nobleman	noblewoman	
uniformity	nonuniformity	
reduced_instruction_set_computer	complex_instruction_set_computer	
conductor	insulator	
reduced_instruction_set_computing	complex_instruction_set_computing	
compression	decompression	
generality	particularity	
embarrassment	disembarrassment	
licitness	illicitness	
driver	nondriver	
tightness	looseness	
respect	disrespect	
inaudibility	audibility	
judgment_in_rem	judgment_in_personam	
high_relief	low_relief	
conformism	nonconformism	
conformist	nonconformist	
untruthfulness	truthfulness	
concentricity	eccentricity	
nonequivalence	equivalence	
intelligence	stupidity	
movableness	immovableness	
ungraciousness	graciousness	
selfishness	unselfishness	
discourtesy	courtesy	
fearfulness	fearlessness	
noncitizen	citizen	
humaneness	inhumaneness	
unacceptability	acceptability	
disfluency	fluency	
overtime	regulation_time	
deactivation	activation	
lateness	earliness	
subscript	superscript	
inconspicuousness	conspicuousness	
untrustiness	trustiness	
liberality	illiberality	
happiness	sadness	unhappiness	
lead	deficit	
goodness	badness	evilness	
flexion	extension	
originality	unoriginality	
feasibility	infeasibility	
loudness	softness	
service	disservice	
dissuasion	persuasion	
increment	decrement	
good_guy	bad_guy	
major_surgery	minor_surgery	
rich	poor	
sensitivity	insensitivity	
unobtrusiveness	obtrusiveness	
union	disunion	separation	
hand_mower	power_mower	
seemliness	unseemliness	
homogeneity	heterogeneity	
insubordination	subordination	
inapplicability	applicability	
ratite	carinate	
nonproliferation	proliferation	
losings	winnings	
source_program	object_program	
intemperance	temperance	
civilian	serviceman	
unlikelihood	likelihood	
initiate	uninitiate	
illness	wellness	
ungodliness	godliness	
unworthiness	worthiness	
homeopathy	allopathy	
former	latter	
inflexibility	flexibility	
hypertension	hypotension	
ready-made	custom-made	
ascending_node	descending_node	
strong_point	weak_point	
past	future	
digitigrade_mammal	plantigrade_mammal	
follower	leader	
attendance	nonattendance	
negativity	positivity	
uncommonness	commonness	
euphemism	dysphemism	
undependability	dependability	
destructibility	indestructibility	
indecorum	decorum	
moderation	immoderation	
honor	dishonor	
maturity	immaturity	
flashback	flash-forward	
hypertonia	hypotonia	
deciduous_plant	evergreen_plant	
closing	opening	
inferiority	superiority	
ineligibility	eligibility	
unpersuasiveness	persuasiveness	
antagonist	agonist	synergist	
discontentment	contentment	
thoughtlessness	thoughtfulness	
secured_bond	unsecured_bond	
concave_polygon	convex_polygon	
soft_drug	hard_drug	
dabbling_duck	diving_duck	
categorem	syncategorem	
liberator	captor	
reliableness	unreliableness	
bad_luck	good_luck	
ingenuousness	disingenuousness	
night_game	day_game	
diffidence	confidence	
introversion	extraversion	ambiversion	
nonconformist	conformist	
applicability	inapplicability	
nonconformism	conformism	
agreeableness	disagreeableness	
non-volatile_storage	volatile_storage	
inopportuneness	opportuneness	
participation	nonparticipation	
injudiciousness	judiciousness	
maximum	minimum	
unfriendliness	friendliness	
ineffectiveness	effectiveness	
nonpayment	payment	
spuriousness	genuineness	
divergence	convergence	
divergency	convergency	
salubriousness	insalubriousness	
attractiveness	unattractiveness	
import	export	
dry-bulb_thermometer	wet-bulb_thermometer	
sympatry	allopatry	
assembly	disassembly	
innocence	guilt	
start	finish	
politeness	impoliteness	
conviction	acquittal	
outpatient	inpatient	
safety	danger	
consonant	vowel	
justice	injustice	
ill-being	well-being	
practicality	impracticality	
consistency	inconsistency	
imperceptibility	perceptibility	
deepness	shallowness	
point_of_apoapsis	point_of_periapsis	
accessibility	inaccessibility	
hypothyroidism	hyperthyroidism	
felicity	infelicity	
asynchronism	synchronism	
subtraction	addition	
tonicity	atonicity	
honorableness	dishonorableness	
destabilisation	stabilisation	
mortality	immortality	
badness	goodness	
inefficacy	efficacy	
uncheerfulness	cheerfulness	
loss	gain	
inconstancy	constancy	
universal	particular	
atheism	theism	
contraction	expansion	
discomposure	composure	
logicalness	illogicalness	
nativeness	foreignness	
yes	no	
appositeness	inappositeness	
nonworker	worker	
rural_area	urban_area	
inaction	action	
curliness	straightness	
illegality	legality	
evergreen_plant	deciduous_plant	
creativeness	uncreativeness	
insubstantiality	substantiality	
cognizance	incognizance	
sound	silence	
decriminalisation	criminalisation	
sleeping	waking	
decentralization	centralization	
unhappiness	happiness	
responsiveness	unresponsiveness	
radial_asymmetry	radial_symmetry	
defence	offence	
beginning	middle	end	ending	
conventionality	unconventionality	
immaturity	maturity	
express	local	
indispensableness	dispensableness	
inessentiality	essentiality	
development	nondevelopment	
maleness	femaleness	
stabilization	destabilization	
source	sink	
dependability	undependability	
decision	indecision	
impermeability	permeability	
contentment	discontentment	
opportuneness	inopportuneness	
defendant	plaintiff	
southernness	northernness	
wet_fly	dry_fly	
egoism	altruism	
sentience	insentience	
active_trust	passive_trust	
incentive	disincentive	
synonym	antonym	
astigmatism	stigmatism	
electronic_mail	snail_mail	
good_weather	bad_weather	
indirectness	directness	
sorrow	joy	
straight_line	curve	
Heaven	Hell	
faithfulness	unfaithfulness	
female	male	
sensibility	insensibility	
abundance	scarcity	
powerfulness	powerlessness	
incongruousness	congruousness	
intransitivity	transitivity	
noncompliance	compliance	
tight_money	easy_money	
purposelessness	purposefulness	
potency	impotency	
potence	impotence	
medulla	cortex	
exotoxin	endotoxin	
infidelity	fidelity	
amateur	professional	
levity	gravity	
pronation	supination	
positiveness	negativeness	
trade_edition	text_edition	
nonalignment	alignment	
corruptness	incorruptness	
palpability	impalpability	
penetrability	impenetrability	
indirect_discourse	direct_discourse	
disequilibrium	equilibrium	
nadir	zenith	
text_edition	trade_edition	
periselene	aposelene	
efficiency	inefficiency	
unceremoniousness	ceremoniousness	
granter	withholder	
intangibility	tangibility	
weed	cultivated_plant	
inability	ability	
competition	cooperation	
errancy	inerrancy	
wholesale	retail	
maleficence	beneficence	
winnings	losings	
uptick	downtick	
eating_apple	cooking_apple	
wife	husband	
tragedy	comedy	
uninterestingness	interestingness	
libertarian	necessitarian	
closed_chain	open_chain	
activator	inhibitor	
prescription_medicine	over-the-counter_medicine	
closeness	openness	
faintheartedness	stoutheartedness	
fame	infamy	
extensor	flexor	
favorableness	unfavorableness	
demand	supply	
pointedness	unpointedness	
question	answer	
descriptive_linguistics	prescriptive_linguistics	
syncategorem	categorem	
solidity	porosity	hollowness	
gracefulness	awkwardness	
peace	war	
wildness	tameness	
friendliness	unfriendliness	
multidimensional_language	one-dimensional_language	
falsity	truth	
inexperience	experience	
hypersomnia	insomnia	
youngness	oldness	
ceremoniousness	unceremoniousness	
compressibility	incompressibility	
enfranchisement	disenfranchisement	
Arabic_numeral	Roman_numeral	
neurotic_depression	psychotic_depression	
son	daughter	
fear	fearlessness	
local	express	
disembarrassment	embarrassment	
ability	inability	
opening	closing	
emotional_person	unemotional_person	
unconventionality	conventionality	
conclusiveness	inconclusiveness	
employment	unemployment	
egalitarian	elitist	
relevance	irrelevance	
odd-toed_ungulate	even-toed_ungulate	
tardiness	punctuality	
narrow-mindedness	broad-mindedness	
unmindfulness	mindfulness	
perilune	apolune	
downtick	uptick	
exogamy	endogamy	
hypoparathyroidism	hyperparathyroidism	
demotion	promotion	
inaptitude	aptitude	
apophatism	cataphatism	doctrine_of_analogy	
foe	friend	
Anglophilia	Anglophobia	
atypicality	typicality	
thoughtfulness	unthoughtfulness	thoughtlessness	
attraction	repulsion	
capitalism	socialism	
unkindness	kindness	
cenobite	eremite	
categoreme	syncategoreme	
synchronous_operation	asynchronous_operation	
fast_reactor	thermal_reactor	
ingratitude	gratitude	
action	inaction	
young	aged	
Romanticism	classicism	
likeness	unlikeness	
wakefulness	sleepiness	
pigmentation	depigmentation	
appreciation	depreciation	
synchronization	desynchronization	
cenogenesis	palingenesis	
acceptance	rejection	
evenness	unevenness	
political_correctness	political_incorrectness	
inclination	disinclination	
agreement	disagreement	
meaningfulness	meaninglessness	
dislike	liking	
ending	beginning	
dry_fly	wet_fly	
gradualness	abruptness	
there	here	
ebbtide	flood_tide	
secureness	insecureness	
advisability	inadvisability	
volley	ground_stroke	
profitableness	unprofitableness	
soundness	unsoundness	
wave_theory_of_light	corpuscular_theory_of_light	
sister	brother	
disapproval	approval	
construction	misconstruction	
inattention	attention	
leeward	windward	
impenetrability	penetrability	
balance	imbalance	
implausibility	plausibility	
strength	weakness	
left	right	
illogicality	logicality	
night_school	day_school	
inadvisability	advisability	
security	insecurity	
accuracy	inaccuracy	
minimization	maximization	
male_sibling	female_sibling	
unlikeness	likeness	
divergent_thinking	convergent_thinking	
liability	asset	
malevolence	benevolence	
compatibility	incompatibility	
common_noun	proper_noun	
convex_polygon	concave_polygon	
female_child	male_child	
promotion	demotion	
non-engagement	engagement	
optimism	pessimism	
ground	figure	
proportion	disproportion	
immodesty	modesty	
husband	wife	
concern	unconcern	
good_nature	ill_nature	
deficit	lead	
ovulation	anovulation	
pastness	futurity	presentness	
completeness	incompleteness	
mutability	immutability	
actual_sin	original_sin	
impiety	piety	
hardware	software	
old_style	modern	
alkalinity	acidity	
sink	source	
obedience	disobedience	
good_fortune	misfortune	
incongruity	congruity	
effector	receptor	
lawfulness	unlawfulness	
factuality	counterfactuality	
perijove	apojove	
oldness	youngness	newness	
discouragement	encouragement	
evilness	goodness	
unwholesomeness	wholesomeness	
eugenics	dysgenics	
suitability	unsuitability	
ill_humor	good_humor	
defense	offense	prosecution	
resident	nonresident	
irresponsibleness	responsibleness	
liking	dislike	
impatience	patience	
imprudence	prudence	
inelegance	elegance	
type	antitype	
right_angle	oblique_angle	
distributary	tributary	
femaleness	maleness	
niece	nephew	
self-fertilization	cross-fertilization	
undergarment	overgarment	
cross-pollination	self-pollination	
stillborn_infant	liveborn_infant	
male_aristocrat	female_aristocrat	
hypotonia	hypertonia	
male_child	female_child	
disingenuousness	ingenuousness	
seasonableness	unseasonableness	
patience	impatience	
interference	noninterference	
mental_illness	mental_health	
open_interval	closed_interval	
black	white	
honesty	dishonesty	
ill_health	good_health	
immoderation	moderation	
heterogeneity	homogeneity	
fall	rise	
formality	informality	
sitting_trot	rising_trot	
pleasure	pain	
larboard	starboard	
courage	cowardice	
positivity	negativity	
unemotional_person	emotional_person	
indication	contraindication	
resoluteness	irresoluteness	
back	front	
fast_lane	slow_lane	
rejection	acceptance	
profundity	superficiality	
imperviousness	perviousness	
dirtiness	cleanness	
catabolism	anabolism	
wave_theory	corpuscular_theory	
monophony	polyphony	
likelihood	unlikelihood	
retail	wholesale	
gravity	levity	
ambiguity	unambiguity	
anapsid	diapsid	
corporeality	incorporeality	
parallel_operation	serial_operation	
anamorphism	katamorphism	
convergent_thinking	divergent_thinking	
hate	love	
thinness	thickness	
irresoluteness	resoluteness	
emptiness	fullness	
unreality	reality	
asymmetry	symmetry	
studio	location	
shortness	tallness	longness	
Lord	Lady	
ancestor	descendant	
unfitness	fitness	
accrual_basis	cash_basis	
trust	distrust	
specific	general	
insolubility	solubility	
self-consciousness	unselfconsciousness	
dry_season	rainy_season	
no	yes	
eudemon	cacodemon	
hypopnea	hyperpnea	
advantage	disadvantage	
fauna	flora	
hyponatremia	hypernatremia	
margin_account	cash_account	
apex	antapex	
equality	inequality	
natural_depression	natural_elevation	
nonvolatile_storage	volatile_storage	
good_person	bad_person	
cortex	medulla	
apojove	perijove	
impoliteness	politeness	
good	bad	evil	
meaninglessness	meaningfulness	
veracity	mendacity	
homocercal_fin	heterocercal_fin	
technophobe	technophile	
curve	straight_line	
worst	best	
graciousness	ungraciousness	
hypopigmentation	hyperpigmentation	
incompleteness	completeness	
smoothness	roughness	
inequality	equality	
inappropriateness	appropriateness	
emersion	immersion	
underachievement	overachievement	
unsanitariness	sanitariness	
loading	unloading	
elasticity	inelasticity	
nationalization	denationalization	
eukaryote	prokaryote	
fearlessness	fear	fearfulness	
separation	union	
digestibility	indigestibility	
constructiveness	destructiveness	
stander	sitter	
outflow	inflow	
functional_disorder	organic_disorder	
disproportion	proportion	
unlikeliness	likeliness	
incapability	capability	
darkness	lightness	
unwillingness	willingness	
monetization	demonetization	
caution	incaution	
impotence	potence	
adience	abience	
willingness	unwillingness	
hereness	thereness	
respectability	unrespectability	
immunocompetence	immunodeficiency	
misconstruction	construction	
cash_basis	accrual_basis	
allopathy	homeopathy	
tallness	shortness	
highness	lowness	
salient_angle	reentrant_angle	
polyphonic_music	monophonic_music	
exon	intron	
vernal_equinox	autumnal_equinox	
disrespect	respect	
adaptability	unadaptability	
temperance	intemperance	
direct_current	alternating_current	
cataphatism	apophatism	doctrine_of_analogy	
dark	light	
malignancy	benignancy	
inconvertibility	convertibility	
autumnal_equinox	vernal_equinox	
tail	head	
broad-mindedness	narrow-mindedness	
stigmatism	astigmatism	
rusticity	urbanity	
serviceman	civilian	
religious_person	nonreligious_person	
hypovolemia	hypervolemia	
high_explosive	low_explosive	
egress	ingress	
masculinity	femininity	
unoriginality	originality	
desynchronizing	synchronizing	
logicality	illogicality	
eccentricity	concentricity	
poverty	wealth	
peristalsis	anastalsis	
bad_guy	good_guy	
disarming	arming	
unrelatedness	relatedness	
ingress	egress	
imperfection	perfection	
courtesy	discourtesy	
generalist	specialist	
hawkishness	dovishness	
convergency	divergency	
convergence	divergence	
exactness	inexactness	
distribution	concentration	
variedness	unvariedness	
disenfranchisement	enfranchisement	
unevenness	evenness	
unperceptiveness	perceptiveness	
reality_principle	pleasure_principle	
latter	former	
timidity	boldness	
layman	clergyman	
tightening	loosening	
political_incorrectness	political_correctness	
unneighborliness	neighborliness	
birth	death	
out-basket	in-basket	
disinclination	inclination	
isotropy	anisotropy	
deflation	disinflation	inflation	
war	peace	
volatile_storage	nonvolatile_storage	non-volatile_storage	
unsolvability	solvability	
yin	yang	
anticyclone	cyclone	
incivility	civility	
direct_discourse	indirect_discourse	
original_sin	actual_sin	
hypoglycemia	hyperglycemia	
hyperthyroidism	hypothyroidism	
unconsciousness	consciousness	
inclusion	exclusion	
flood_tide	ebbtide	
low	high	
non-dedicated_file_server	dedicated_file_server	
dishonorableness	honorableness	
zygodactyl_foot	heterodactyl_foot	
Roman_numeral	Arabic_numeral	
straightness	curliness	crookedness	
unpermissiveness	permissiveness	
palatability	unpalatability	
pleasingness	unpleasingness	
bad_egg	good_egg	
wrongness	rightness	
largeness	smallness	
intractability	tractability	
providence	improvidence	
nondrinker	drinker	
technophile	technophobe	
waking	sleeping	
newness	oldness	
levorotation	dextrorotation	
oblique_angle	right_angle	
unsoundness	soundness	
hostile	friendly	
call_option	put_option	
continuance	discontinuance	
unthoughtfulness	thoughtfulness	
danger	safety	
varietal	generic	
discontinuation	continuation	
insurability	uninsurability	
e-mail	snail_mail	
salubrity	insalubrity	
proper_noun	common_noun	
invisibility	visibility	
thin_person	fat_person	
possibility	impossibility	
unstableness	stableness	
insecureness	secureness	
preparation	resolution	
modern	old_style	
rich_people	poor_people	
otherworldliness	worldliness	
efficacy	inefficacy	
inelasticity	elasticity	
fullness	emptiness	
interestingness	uninterestingness	
levitation	gravitation	
failure	success	
insolvency	solvency	
hypocalcemia	hypercalcemia	
predictability	unpredictability	
inequity	equity	
segregation	integration	
low_pitch	high_pitch	
legitimacy	illegitimacy	
abruptness	gradualness	
polytheism	monotheism	
hot_war	cold_war	
changeableness	changelessness	
particular_proposition	universal_proposition	
difference	sameness	
responsibility	irresponsibility	
association	disassociation	
cyclone	anticyclone	
disobedience	obedience	
closed_interval	open_interval	
merit_system	spoils_system	
reverse	obverse	
dishonor	honor	
timid	brave	
adequacy	inadequacy	
urbanity	rusticity	
synergist	antagonist	
tactfulness	tactlessness	
legality	illegality	
decorum	indecorum	
disconnectedness	connectedness	
inferior	superior	
impossibility	possibility	
criminalization	decriminalization	
correctness	incorrectness	
top	bottom	
motility	immotility	
surface_mail	air_mail	
continuity	discontinuity	
indecision	decision	
mother	father	
practicableness	impracticableness	
intolerance	tolerance	
loosening	tightening	
monism	pluralism	
impracticality	practicality	
presence	absence	
synthesis	analysis	
timeliness	untimeliness	
attentiveness	inattentiveness	
outside	inside	
satisfaction	dissatisfaction	
stabile	mobile	
vowel	consonant	
reward	penalty	
inflation	disinflation	deflation	
free_state	slave_state	
usualness	unusualness	
unwellness	wellness	
obverse	reverse	
generic	varietal	
immobility	mobility	
variableness	invariableness	
extraordinariness	ordinariness	
disincentive	incentive	
achiever	loser	
decline	improvement	
inanimateness	animateness	
essential	inessential	
extraversion	ambiversion	introversion	
individuality	commonality	
ripeness	greenness	
domestic_flight	international_flight	
light	dark	
plural	singular	
Hell	Heaven	
hypokalemia	hyperkalemia	
plaintiff	defendant	
good_health	ill_health	
aposelene	periselene	
non-proliferation	proliferation	
encouragement	discouragement	
hypotonicity	hypertonicity	
hyperpigmentation	hypopigmentation	
proportional_font	fixed-width_font	
windward	leeward	
square_shooter	liar	
permeability	impermeability	
unsuitableness	suitableness	
earned_run	unearned_run	
misfortune	good_fortune	
Arianism	Athanasianism	
white	black	
expediency	inexpediency	
expedience	inexpedience	
time_off	work_time	
imperfectibility	perfectibility	
harmony	dissonance	
right	wrong	left	
male_parent	female_parent	
indiscipline	discipline	
unprofitableness	profitableness	
romanticist	classicist	
offense	defense	
dove	hawk	
incapacity	capacity	
inerrancy	errancy	
artifact	natural_object	
summer_solstice	winter_solstice	
low_status	high_status	
brave	timid	
auspiciousness	inauspiciousness	
prominence	obscurity	
regularity	irregularity	
nationalism	internationalism	multiculturalism	
mutableness	immutableness	
seriousness	frivolity	
unreliableness	reliableness	
male	female	
nonintervention	intervention	
equity	inequity	
infertility	fertility	
alterability	unalterability	
disorder	order	
unsecured_bond	secured_bond	
insensitivity	sensitivity	
hypertonus	hypotonus	
wrongfulness	rightfulness	
air_mail	surface_mail	
consideration	inconsideration	
unresponsiveness	responsiveness	
infamy	fame	
thermal_reactor	fast_reactor	
communicativeness	uncommunicativeness	
inadequacy	adequacy	
wideness	narrowness	
anticatalyst	catalyst	
kinesthesia	kinanesthesia	
descendant	ancestor	
elitist	egalitarian	
withholder	granter	
superscript	subscript	
observance	nonobservance	
low_explosive	high_explosive	
taper_file	blunt_file	
inexplicitness	explicitness	
inflationary_spiral	deflationary_spiral	
indecency	decency	
unfaithfulness	faithfulness	
aliquant	aliquot	
katamorphism	anamorphism	
flash-forward	flashback	
incomprehensibility	comprehensibility	
emotionality	unemotionality	
dangerousness	safeness	
inefficiency	efficiency	
parallelogram	trapezium	
Cryptogamia	Phanerogamae	
male_offspring	female_offspring	
immorality	morality	
partisan	nonpartisan	
nonreligious_person	religious_person	
rising_trot	sitting_trot	
insentience	sentience	
improvement	decline	
offence	defence	
inappositeness	appositeness	
involvement	non-involvement	
hyperthermia	hypothermia	
incurableness	curableness	
point_of_periapsis	point_of_apoapsis	
utopia	dystopia	
work_time	time_off	
concentration	distribution	dilution	
mobile	stabile	
undesirability	desirability	
monotheism	polytheism	
gravitation	levitation	
back_burner	front_burner	
closed_circuit	open_circuit	
detribalisation	tribalisation	
trapezium	parallelogram	
outwardness	inwardness	
benevolence	malevolence	
conformity	nonconformity	
unaffectedness	affectedness	
insulator	conductor	
front	back	rear	
high_season	off-season	
discontinuity	continuity	
wholesomeness	unwholesomeness	
drinker	nondrinker	
man	woman	
sufficiency	insufficiency	
well-being	ill-being	
necessitarian	libertarian	
righteousness	unrighteousness	
hyperparathyroidism	hypoparathyroidism	
importance	unimportance	
socialism	capitalism	
coordination	incoordination	
dysphoria	euphoria	
narrowness	wideness	
non-market_economy	market_economy	
similarity	dissimilarity	
civility	incivility	
flora	fauna	
allopatry	sympatry	
answer	question	
inactivity	activity	
weakness	strength	
nastiness	niceness	
orderliness	disorderliness	
tolerance	intolerance	
high_pitch	low_pitch	
mushroom	toadstool	
unfamiliarity	familiarity	
unpleasingness	pleasingness	
affinity	consanguinity	
insanity	sanity	
atomism	holism	
flexibility	inflexibility	
insalubrity	salubrity	
extrovert	introvert	
insincerity	sincerity	
RISC	CISC	
sameness	difference	
parent	child	
disesteem	esteem	
natural_elevation	natural_depression	
understatement	overstatement	
nonobservance	observance	
hypercalcemia	hypocalcemia	
outfield	infield	
unselfishness	selfishness	
inexpedience	expedience	
inexpediency	expediency	
unmalleability	malleability	
internationalism	nationalism	
aptitude	inaptitude	
particular	universal	general	
day_game	night_game	
desirability	undesirability	
creditor	debtor	
drunkenness	soberness	
heedlessness	heedfulness	
aged	young	
directness	indirectness	
open_chain	closed_chain	
unlisted_security	listed_security	
anovulation	ovulation	
immateriality	materiality	
lightness	heaviness	darkness	
blunt_file	taper_file	
low_relief	high_relief	
tactlessness	tactfulness	
calmness	agitation	
depression	elation	
rotor	stator	
kinanesthesia	kinesthesia	
impotency	potency	
transitivity	intransitivity	
ground_stroke	volley	
discomfort	comfort	
unavailability	availability	
irregularity	regularity	
invariability	variability	
highland	lowland	
Nonconformist	Anglican	
con	pro	
arming	disarming	
anestrus	estrus	
host	parasite	
concreteness	abstractness	
female_monarch	male_monarch	
stratified_language	unstratified_language	
profitability	unprofitability	
inhospitableness	hospitableness	
asset	liability	
evil	good	
queen	king	
undependableness	dependableness	
disagreeableness	agreeableness	
periapsis	apoapsis	
fair_ball	foul_ball	
abience	adience	
impropriety	propriety	
brother	sister	
theism	atheism	
inconclusiveness	conclusiveness	
fluency	disfluency	
sunrise	sunset	
motion	motionlessness	
deceleration	acceleration	
dryness	wetness	
fixedness	looseness	
illiberality	liberality	
continuation	discontinuation	
immunodeficiency	immunocompetence	
hypothermia	hyperthermia	
weak_point	strong_point	
overstatement	understatement	
hopelessness	hopefulness	
weak_part	good_part	
antinode	node	
simplicity	complexity	
open_circuit	closed_circuit	
futurity	pastness	presentness	
hard_water	soft_water	
grand_larceny	petit_larceny	
analysis	synthesis	
immovableness	movableness	
sanitariness	unsanitariness	
incoherence	coherence	
philogyny	misogyny	
over-the-counter_drug	prescription_drug	
unenlightenment	enlightenment	
discontinuance	continuance	
commonness	uncommonness	
organic_disorder	functional_disorder	
singular_matrix	nonsingular_matrix	
destructiveness	constructiveness	
neighborliness	unneighborliness	
indigestibility	digestibility	
nominative	oblique	
fresh_water	saltwater	
leader	follower	
regulation_time	overtime	
significance	insignificance	
